#########
#.......#
#.o..#x##
#.#.o...#
#..@.ox.#
#########